#       SCCS Id: @(#)Ice.des       3.4     1991/09/30
#       Copyright (c) 1989 by Jean-Christophe Collet
#       Copyright (c) 1991-2 by M. Stephenson
#       Copy(rightish)Modified by Ozma777 liked this ice map better
# NetHack may be freely redistributed.  See license for details.
#
#       The "start" level for the quest.
#
#       Here you meet your (besieged) class leader, the High Ice Mage,
#       and receive your quest assignment.
# I know this is similar to metal mage, it is because originally I changed Ice to Metal and then thought that the changed quest layout idea was cool.
MAZE: "Ice-strt",' '
FLAGS: noteleport,hardfloor
GEOMETRY:center,center
MAP
CCCIPIIIIIIIPIIIIIIIIITIIIIIIICIIIIIIIIIIII.PCIIIIIAIIIIIPIIIIIAACIIIIIPIIII
CLPCIPPIIIIPPPIIIIIIFIIITIIIIPPIIIIII.IIIIII.L.IAIAIIIPIIIII.IIITACIIAIIFIII
CCLPCPPPIIPLLPIIIII.AATAAATAAAL.LLLLIIIII.III.ITITIIIIAIIIA  .IPTTACIITII.II
CPLLPCPPIIPPPTIIIIAAA.....TT.PP...LLLIIITIAIIIIII.IIITIIIIA  .IPPTACIIAIIIII
PCLLPCCPPIIPIIIII T..TAAAAAT  P TT..LLIIIIIIITIIIIII.IIAIIA I.IPPACIIII.IIII
CLLLPCCCPPPIIIIITT.TAAAIIIIT.  T....TLCIITI.IIIATIIIIIIIIA  I.APLPCAIIIIIIII
CLLPCCCCCPPPIIII...AA.IIIPP TT.P.CCCLLC AIIIIITIIIITIIAIA  I.IIAPLPCIITIAIII
CCLLPCCCCCPPI.....AATIIATT T.   CCILLLICC.TIII .IIII.IIIA  II.IAIPLPCIII.ITI
CPLLLPCCCCPIC .P.T.IIIA TL..T  CIILLLLIIICC II IAIIIIIAIIA  I.IAPLPCII.ITIII
CC.LLPCCCTICICII ITIIA ..P.T  CIIIPLLLPPIICCCTCIII.TIIIIIA  II.IPLTPCIIAIIII
..PCLLPCTCCCCIIIIIIIA ..PAL TCIIPPPALLAPPPIICTCCIIAIIIIIIA  III.ICPTPCIII.II
APLC..PPTTCTCICII IIA.. TCT.TIIPPAAAALAAAPPIICTCIITIATIA  IIIAAT.TTTCPI.IITI
PTC.....TTTTTIICIIIIA ...ATT TIIPPPAAAAPPPIICCCCIIIIIIA  IIIAAAPC.TTTCPII.AI
LLPC...TTTCTTICIIIITIA  TT T .TIIIPP..PPIIICCCCCIAI.IA   IIAICLLP.ITTTCPIIII
LLLPC.CTCTTTTTICI IIIIIIIPTP.ITTTII.II.ITTCCCCCII.IIA   IIAICLCC.CCTTCPIIAII
LLPIIIITTTTCTTTICII ITIIIIPTI.IPPTII..IITCCCCC.IIIIIA  IIAIPLLLC...ITACPII.I
IIICIIIICCIICIICIIIIIIIIIIIPT.TPI TTTTTTCCCCCIIIIIAA  IIAIPLLLL.....TTAPIIAI
ICIIIICICIICIICIIIIITIIITIITPPTIPICICCICICCCIII.IA  IIIIAIPLLPPL...PPPPIIAII
IIICICICICCICIICIIITIIITTILAP IPITICIICICICCICIIIA  IIIAIAICCPPPTTTPPAIII.II
IICICIIIICIIICIII IIIIITILPLL IIPICICIICIIIICI.IA  IIIIIAIIIICCPPTPPIIIAIII.
ENDMAP
# Random Monsters
RANDOM_MONSTERS: 'D', 'E'
# Dungeon Description
REGION:(00,00,75,19),lit,"ordinary"
# Portal arrival point
BRANCH:(65,16,65,16),(0,0,0,0)
# Stairs
STAIR:(05,12),down
# High Ice Mage
MONSTER:'@',"High Ice Mage",(36,11)
# The treasure of the High Ice Mage
OBJECT:'(',"chest",(37,11)
# guards for the audience chamber
MONSTER:'@',"froster",(35,10)
MONSTER:'@',"froster",(35,11)
MONSTER:'@',"froster",random
MONSTER:'@',"froster",random
MONSTER:'@',"froster",random
MONSTER:'@',"froster",random
MONSTER:'@',"froster",random
MONSTER:'D',"baby white dragon",random,peaceful
MONSTER:'D',"white dragon",random,peaceful
MONSTER:'D',"white dragon",random,peaceful
MONSTER:'D',"stone dragon",random,hostile
MONSTER:'D',"baby black dragon",random,hostile
# Non diggable 
NON_DIGGABLE:(00,00,75,19)
# Random traps
TRAP:"falling rock",random
TRAP:"falling rock",random
TRAP:"falling rock",random
TRAP:"falling rock",random
TRAP:"falling rock",random
TRAP:"falling rock",random
TRAP:"magic",random
TRAP:"magic",random
# Monsters on siege duty.
MONSTER: 'E',"earth elemental",random,hostile
MONSTER: 'E',"earth elemental",random,hostile
MONSTER: 'E',"earth elemental",random,hostile
MONSTER: 'E',"earth elemental",random,hostile
MONSTER: 'E',"earth elemental",random,hostile
MONSTER: 'E',"earth elemental",random,hostile
MONSTER: 'E',"earth elemental",random,hostile
MONSTER: 'E',"earth elemental",random,hostile
MONSTER: 'X',"xorn",random,hostile
MONSTER: 'X',"xorn",random,hostile
MONSTER: 'X',"xorn",random,hostile
MONSTER: 'X',"xorn",random,hostile
 
#
#       The "locate" level for the quest.
#
#       Here you have to find the stairs to go
#       further towards your assigned quest.
#

MAZE: "Ice-loca",' '
FLAGS: hardfloor
INIT_MAP: '.' , ' ' , true , true , lit , false
GEOMETRY:center,center
MAP
    IIII     II   III     II IIIII    II
   III I    I  I  I I       I I II     I
  I   I IITIAIIAIIIIIIIIIIII I I  I     
II   IIIAIIIIIIIITII IIIIIIIAIIII  I   I
I  IIIIIACIPIIIIIII I IIIIAIIIPTII  IIII
  IIIIIAAAC CIIIII IAI IAIIIIITIIII   II
IIIIIIIIACC  IIII ITIII IAIIPTITIIII   I
  IIIIIAIAIACIIITIIICIIICIII ITIIIIII   
I  IIIIATIIIICI IIIIIIIIITIPTIIIIIIII  I
II   IAIITAIII ITIIIIIIITIIIITIIIII   II
  I   IIAIIITIIIIIIIIIIIIIIITIII     I  
   II    AIA A I   IAA AI A I A   III    
   IIIIAIAA  I AAIA  IA   I  I  IIII   I
ENDMAP
# Random Monsters
RANDOM_MONSTERS: 'E', 'R'
# Dungeon Description
REGION:(00,00,39,12),lit,"ordinary"
# Stairs
STAIR:(48,14),up
STAIR:(20,06),down
# Objects
OBJECT:random,random,random
OBJECT:random,random,random
OBJECT:random,random,random
OBJECT:random,random,random
OBJECT:random,random,random
OBJECT:random,random,random
OBJECT:random,random,random
OBJECT:random,random,random
OBJECT:random,random,random
# Random traps
TRAP:"falling rock",random
TRAP:"falling rock",random
TRAP:"falling rock",random
TRAP:"falling rock",random
TRAP:random,random
TRAP:random,random
# Random monsters.
MONSTER:'E',"earth elemental",random,hostile
MONSTER:'E',"earth elemental",random,hostile
MONSTER:'E',"earth elemental",random,hostile
MONSTER:'E',"earth elemental",random,hostile
MONSTER:'E',"earth elemental",random,hostile
MONSTER:'E',"earth elemental",random,hostile
MONSTER:'E',"earth elemental",random,hostile
MONSTER:'E',"earth elemental",random,hostile
MONSTER:'E',"earth elemental",random,hostile
MONSTER:'E',"earth elemental",random,hostile
MONSTER:'D',"stone dragon",random,random
MONSTER:'X',"xorn",random,hostile
MONSTER:'X',"xorn",random,hostile
MONSTER:'X',"xorn",random,hostile
MONSTER:'X',"xorn",random,hostile

#
#       The "goal" level for the quest.
#
#       Here you meet the Stone Mage, your nemesis monster.  You have
#       to defeat him in combat to gain the artifact you have
#       been assigned to retrieve.
#

MAZE: "Ice-goal", 'P'
INIT_MAP: '.' , ' ' , true , true , lit , false
GEOMETRY:center,center
MAP
...................................
..I.I            I           I.I...
.I.        .............        .I.
..       ..I|---------|I..       ..
I       .I|--.........--|I.       I
        .|-..I   S   I..-|.        
       .I|..I  .I..I  I..|I.       
       .|-.I  I...I..  I.-|.       
       .|..I  ..I...I  I..|.       
       .|-.I  I...I..  I.-|.       
       .I|..I  .I.I.  I..|I.       
        .|-..I   S   I..-|.        
I       .I|--.........--|I.       I
..       ..I|---------|I..       ..
..I        .............        I..
.I..I            I            I..I.
...................................
ENDMAP
# Random Monsters
RANDOM_MONSTERS: 'E', 'R'
# Dungeon Description
REGION:(00,00,34,16),lit,"ordinary"
# Stairs
# Note:  The up stairs are *intentionally* off of the map.
STAIR:(45,10),up
# Drawbridges
DRAWBRIDGE:(17,02),south,closed
DRAWBRIDGE:(17,14),north,closed
# Objects
OBJECT:')',"quarterstaff",(17,08),blessed,0,"The Staff Of Ancient Ice"
OBJECT:random,random,random
OBJECT:random,random,random
OBJECT:random,random,random
OBJECT:random,random,random
OBJECT:random,random,random
OBJECT:random,random,random
OBJECT:random,random,random
# Random traps
TRAP:"falling rock",random
TRAP:"falling rock",random
TRAP:"falling rock",random
TRAP:"falling rock",random
TRAP:random,random
TRAP:random,random
# KMH, balance patch 2 -- all quests now have an altar
ALTAR:(17,08),noalign,altar
# Random monsters.
MONSTER:'@',"Stone Mage",(17,08)
MONSTER:'E',"earth elemental",random,hostile
MONSTER:'E',"earth elemental",random,hostile
MONSTER:'E',"earth elemental",random,hostile
MONSTER:'E',"earth elemental",random,hostile
MONSTER:'E',"earth elemental",random,hostile
MONSTER:'E',"earth elemental",random,hostile
MONSTER:'E',"earth elemental",random,hostile
MONSTER:'E',"earth elemental",random,hostile
MONSTER:'D',"black dragon",random,hostile
MONSTER:'X',"xorn",random,hostile
MONSTER:'X',"xorn",random,hostile
MONSTER:'X',"xorn",random,hostile
MONSTER:'X',"xorn",random,hostile
MONSTER:'X',"xorn",random,hostile

#
#       The "fill" levels for the quest.
#
#       These levels are used to fill out any levels not occupied by specific
#       levels as defined above. "filla" is the upper filler, between the
#       start and locate levels, and "fillb" the lower between the locate
#       and goal levels.
#

MAZE: "Ice-fila" , 'I'
INIT_MAP: '.' , 'I' , true , true , lit, false
NOMAP
#
STAIR: random, up
STAIR: random, down
#
OBJECT: random, random, random
OBJECT: random, random, random
OBJECT: random, random, random
OBJECT: random, random, random
OBJECT: random, random, random
OBJECT: random, random, random
#
MONSTER: 'E', "earth elemental", random
MONSTER: 'E', "earth elemental", random
MONSTER: 'E', "earth elemental", random
MONSTER: 'E', "earth elemental", random
MONSTER: 'E', "earth elemental", random
MONSTER: 'E', "earth elemental", random
MONSTER: 'E', "earth elemental", random
MONSTER: 'X', "xorn", random, hostile
MONSTER: 'X', "xorn", random, hostile
MONSTER: 'X', "xorn", random, hostile
#
TRAP: random, random
TRAP: random, random
TRAP: random, random
TRAP: random, random
TRAP: random, random
TRAP: random, random
TRAP: random, random

MAZE: "Ice-filb" , ' '
INIT_MAP: '.' , ' ' , true , true , lit, false
NOMAP
#
STAIR: random, up
STAIR: random, down
#
OBJECT: random, random, random
OBJECT: random, random, random
OBJECT: random, random, random
OBJECT: random, random, random
OBJECT: random, random, random
#
MONSTER: 'E', "earth elemental", random
MONSTER: 'E', "earth elemental", random
MONSTER: 'E', "earth elemental", random
MONSTER: 'E', "earth elemental", random
MONSTER: 'E', "earth elemental", random
MONSTER: 'E', "earth elemental", random
MONSTER: 'E', "earth elemental", random
MONSTER: 'X', "xorn", random, hostile
MONSTER: 'X', "xorn", random, hostile
#
TRAP: "falling rock", random
TRAP: "falling rock", random
TRAP: "falling rock", random
TRAP: "falling rock", random
TRAP: "falling rock", random
TRAP: random, random
TRAP: random, random
