#       SCCS Id: @(#)Metal.des       3.4     1991/09/30
#       Copyright (c) 1989 by Jean-Christophe Collet
#       Copyright (c) 1991-2 by M. Stephenson
#       Copyleft Ozma777
# NetHack may be freely redistributed.  See license for details.
#
#       The "start" level for the quest.
#
#       Here you meet your (besieged) class leader, the High Metal Mage,
#       and receive your quest assignment.
#
MAZE: "Met-strt",' '
FLAGS: noteleport,hardfloor
GEOMETRY:center,center
MAP
CCCTPC.TTTTTPTTTTTTTTTTTTTTTTTCTTTTTTTTTTTT.PCTTTTTATTTTTPACTTTAACTTTTTPTTTT
CLPCAPP.TTTPPPTT.TTTFTTTTTTTTPPTTTTTT.TTTTFT.L.TATATTTPTT.TT.TTTTACTTATTFTTT
CCLPCPPP.TPLLPTTTTT.  T   T   L.    TTTTT.TTT.TTTTTTTTATATAFF.TPTTACTTTTT.TT
CPLLPCPPTCPPPT.TTT  A.....TT.PP..... TTTTTATTTTTT.TTTT.TT.AFF.TPPTACTTATTTTT
PCLLPCCPPTCPTTTTT T..T     T  P TT..P TTTTTTTTTFTTTT.TTACTAFT.TPPACTTTT.TTFT
CLLLPCCCPPP.AT.TTT.T   .TTTT.  T....TFCTTTT.TTTAT.TT.TTCTAFFT.APLPCATTTTFTTT
CLLPCCCCCPPPTATT... A.CT.PP TT.P.CCCCCCFATTTTTTTTTTTTTATAFFT.TTAPLPCTTTTATTT
CCLLPCCCCCPPT.....  TCTAT. T.   CCTTTTTCC.TTTT .TTTT.TTTAFFTT.TATPLPCTTT.TTT
CPLLLPCCCCPTC .P.T.TCTA TL..T  FFFFFFFFFFFF TTFTATTTTTATTAFFT.TAPLPCTT.TTTTT
CC.LLPCCCTTC.CTTFTTCTA ..P.T  FFFF------FFFFCTCTTT.TTTTTTAFFTT.TPLTPCTTATTTT
..PLLLPCTCCCCTTTTFTTA ..PALAFFFF---AAAA---FFFFCCTTATTTTTTAFFTTT.TCPTPCTTT.TT
APAC.. PTTCTCTCTTFTTA.. TCT.FFF--AAAAAAAA--FFFTCTTTTATTAFFTTTAAT.TTTCPT.TTTT
PTC.... TTTTFTTCTTTTA ...ATTAFFF---AAAA---FFFCCCTTTTTTAFFTTTAAAPC.TTTCPTT.AT
LLPC...T TCTTTCTTTTTTA  TT T .FFFF--SS--FFFF.ATCTAT.TAFFFTTATCLLP.TTTTCPTTTT
LLLPC.C CTTTTTTCTFTT.TTTTPTP.TTFFFF.TT.FFFFTT.ATT.TTAFFFTTATCLCC.CCTTCPTTATT
LLPT T TTTTCTFTTCTTFTTTTTTPTT.TPPTTT..TTTCCCCC.TTTTTAFFTTATPLLLC...TTACPTT.T
TTTC T TCCTTCTTCTTTTFTTTTTTPT.CPT TTCCCCCCCCCTTTTTAAFFTTATPLLLL.....TTAPTTAT
TCTTTTCTCTTCTTCTTTFTFTT.TTTTPPT.PACTCCTCTCCCTTT.TAFFTTTTATPLLPPL...PPPPTTATT
TTTCTCTCTCCTCTTCTT.TTTFTTTLAPFTPATACTTCTCTCCTCTTTAFFTTTATATCCPPPTTTPPATTT.TT
TTCTCTTFTCTTTCTTTFTTTTTTTLPLLFTTPTCTCTTCTTTTCT.TAFFTTTTTATTTTCCPPTPPTTTATTT.
ENDMAP
# Random Monsters
RANDOM_MONSTERS: ';', 'E', 'Y'
# Dungeon Description
REGION:(00,00,75,19),lit,"ordinary"
# Portal arrival point
BRANCH:(65,16,65,16),(0,0,0,0)
# Stairs
STAIR:(05,12),down
# High Metal Mage
MONSTER:'@',"High Metal Mage",(36,11)
# The treasure of the High Metal Mage
OBJECT:'(',"chest",(37,11)
OBJECT:'(',random,(64,19)
OBJECT:random,random,random
OBJECT:random,random,random
OBJECT:random,random,random
OBJECT:random,random,random
OBJECT:random,random,random
OBJECT:random,random,random
OBJECT:random,random,random
OBJECT:'(',random,random
OBJECT:'(',random,random
OBJECT:'%',random,random
OBJECT:'%',random,random
# guards for the audience chamber
MONSTER:';',random,(61,18)
MONSTER:';',random,(62,18)
MONSTER:';',random,(63,18)
MONSTER:';',random,(61,17)
MONSTER:';',random,(62,17)
MONSTER:';',random,(67,19)
MONSTER:';',random,(66,19)
MONSTER:';',random,(67,17)
MONSTER:';',random,(68,17)
MONSTER:';',random,(69,17)
MONSTER:';',random,(34,13)
MONSTER:';',random,(35,13)
MONSTER:';',random,(35,12)
MONSTER:';',random,(34,12)
MONSTER:';',random,(39,13)
MONSTER:';',random,(38,13)
MONSTER:';',random,(38,12)
MONSTER:';',random,(40,12)
MONSTER:';',random,(41,12)
MONSTER:';',random,(02,01)
MONSTER:';',random,(03,02)
MONSTER:';',random,(04,03)
MONSTER:';',random,(08,05)
MONSTER:';',random,(09,05)
MONSTER:';',random,(10,05)
MONSTER:'@',"metalist",(35,10)
MONSTER:'@',"metalist",(35,11)
MONSTER:'@',"metalist",random
MONSTER:'@',"metalist",random
MONSTER:'@',"metalist",random
MONSTER:'@',"metalist",random
MONSTER:'@',"metalist",random
MONSTER:'@',"metalist",random
MONSTER:'@',"metalist",random
MONSTER:'@',"metalist",random
MONSTER:'@',"metalist",random
MONSTER:'@',"metalist",random
MONSTER:'D',"baby blue dragon",random,peaceful
MONSTER:'D',"blue dragon",random,peaceful
MONSTER:'D',"blue dragon",random,peaceful
MONSTER:'E',"lightning elemental",random,peaceful
MONSTER:'E',"lightning elemental",random,peaceful
MONSTER:'E',"air elemental",random,hostile
MONSTER:'E',"noxious elemental",random,hostile
MONSTER:'B',"harpy",random,hostile
MONSTER:'B',"harpy",random,hostile
MONSTER:'B',"harpy",random,hostile
# Non diggable
NON_DIGGABLE:(00,00,75,19)
# Random traps
TRAP:"falling rock",random
TRAP:"sleep gas",random
TRAP:"sleep gas",random
TRAP:"sleep gas",random
TRAP:random,random
TRAP:"falling rock",random
TRAP:"magic",random
TRAP:"magic",random
# Monsters on siege duty.
MONSTER: 'E',"noxious elemental",random,hostile
MONSTER: 'E',"air elemental",random,hostile
MONSTER: 'E',"lightning elemental",random,peaceful
MONSTER: 'E',"lightning elemental",random,peaceful
MONSTER: 'E',random,random,random
MONSTER: 'Y',"zruty",random,hostile
MONSTER: 'Y',"zruty",random,hostile
MONSTER: 'Y',"zruty",random,hostile
MONSTER: 'Y',"zruty",random,hostile
MONSTER: 'Y',"zruty",random,hostile
MONSTER: 'Y',"zruty",random,random
MONSTER: 'E',"noxious elemental",random,peaceful
MONSTER: 'E',"noxious elemental",random,peaceful
MONSTER: 'E',"lightning elemental",random,peaceful
 
#
#       The "locate" level for the quest.
#
#       Here you have to find the stairs to go
#       further towards your assigned quest.
#

MAZE: "Met-loca",' '
FLAGS: hardfloor
INIT_MAP: '.' , 'A' , true , true , lit , false
GEOMETRY:center,center
MAP
    ....     ..   ...     .. .....    ..
   ... .    .  .  . .       . . ..     .
  .   . ..T.A..A............ . .  .     
..   ...A........T.. .......A....  .   .
.  .....AC.P....... . ....A...PT..  ....
  .....AAAC C..... .A. .A.....T....   ..
........ACC  .... .T... .A..PT.T....   .
  .....A.A.AC...T...C...C... .T......   
.  ....AT....C. .........T.PT........  .
..   .A..TA... .T.......T....T.....   ..
  .   ..A...T...............T...     .  
   ..    A.A A .   .AA A. A . A   ...    
   ....A.AA  . AA.A  .A   .  .  ....   .
ENDMAP
# Random Monsters
RANDOM_MONSTERS: 'E', 'Y'
# Dungeon Description
REGION:(00,00,39,12),lit,"ordinary"
# Stairs
STAIR:(48,14),up
STAIR:(20,06),down
# Objects
OBJECT:random,random,random
OBJECT:random,random,random
OBJECT:random,random,random
OBJECT:random,random,random
OBJECT:random,random,random
OBJECT:random,random,random
OBJECT:random,random,random
OBJECT:random,random,random
OBJECT:random,random,random
# Random traps
TRAP:"dart",random
TRAP:"dart",random
TRAP:"arrow",random
TRAP:"arrow",random
TRAP:random,random
TRAP:random,random
# Random monsters.
MONSTER:'E',"air elemental",random,hostile
MONSTER:'E',"noxious elemental",random,hostile
MONSTER:'E',"air elemental",random,hostile
MONSTER:'E',"noxious elemental",random,hostile
MONSTER:'E',"air elemental",random,hostile
MONSTER:'E',"noxious elemental",random,hostile
MONSTER:'E',"air elemental",random,hostile
MONSTER:'E',"noxious elemental",random,hostile
MONSTER:'E',"air elemental",random,hostile
MONSTER:'E',"air elemental",random,hostile
MONSTER:'B',"harpy",random,hostile
MONSTER:'B',"harpy",random,hostile
MONSTER:'B',"harpy",random,hostile
MONSTER:'B',"harpy",random,hostile

#
#       The "goal" level for the quest.
#
#       Here you meet the Fire Mage, your nemesis monster.  You have
#       to defeat him in combat to gain the artifact you have
#       been assigned to retrieve.
#

MAZE: "Met-goal", 'P'
INIT_MAP: '.' , ' ' , true , true , lit , false
GEOMETRY:center,center
MAP
...................................
.....            .           ......
...        P....PPP....P        ...
..       ...|---------|...       ..
.       ..|--.........--|..       .
        .|-...       ...-|.        
       ..|...  .....  ...|..       
       .|-.P  .......  P.-|.       
       .|..SP|.......|PS..|.       
       .|-.P  .......  P.-|.       
       ..|...  .....  ...|..       
        .|-...       ...-|.        
.       ..|--.........--|..       .
..       ...|---------|...       ..
...        P....PPP....P        ...
.....            .            .....
...................................
ENDMAP
# Random Monsters
RANDOM_MONSTERS: 'E', 'Y'
# Dungeon Description
REGION:(00,00,34,16),lit,"ordinary"
# Stairs
# Note:  The up stairs are *intentionally* off of the map.
STAIR:(45,10),up
# Drawbridges
DRAWBRIDGE:(17,02),south,closed
DRAWBRIDGE:(17,14),north,closed
#DRAWBRIDGE:(13,07),west,closed
#DRAWBRIDGE:(21,07),east,closed temporary fix
# Objects
OBJECT:'(',"magic whistle",(17,08),blessed,0,"The Storm Whistle"
OBJECT:random,random,random
OBJECT:random,random,random
OBJECT:random,random,random
OBJECT:random,random,random
OBJECT:random,random,random
OBJECT:random,random,random
OBJECT:random,random,random
# Random traps
TRAP:"dart",random
TRAP:"dart",random
TRAP:"arrow",random
TRAP:"arrow",random
TRAP:random,random
TRAP:random,random
# KMH, balance patch 2 -- all quests now have an altar
ALTAR:(17,08),noalign,altar
# Random monsters.
MONSTER:'@',"Fire Mage",(17,08)
MONSTER:'E',"air elemental",random,hostile
MONSTER:'E',"air elemental",random,hostile
MONSTER:'E',"noxious elemental",random,hostile
MONSTER:'E',"noxious elemental",random,hostile
MONSTER:'E',"noxious elemental",random,hostile
MONSTER:'E',"noxious elemental",random,hostile
MONSTER:'E',"air elemental",random,hostile
MONSTER:'E',"air elemental",random,hostile
MONSTER:'Y',"zruty",random,hostile
MONSTER:'Y',"zruty",random,hostile
MONSTER:'B',"harpy",random,hostile
MONSTER:'B',"harpy",random,hostile
MONSTER:'B',"harpy",random,hostile

#
#       The "fill" levels for the quest.
#
#       These levels are used to fill out any levels not occupied by specific
#       levels as defined above. "filla" is the upper filler, between the
#       start and locate levels, and "fillb" the lower between the locate
#       and goal levels.
#

MAZE: "Met-fila" , 'I'
INIT_MAP: '.' , 'T' , true , true , lit, false
NOMAP
#
STAIR: random, up
STAIR: random, down
#
OBJECT: random, random, random
OBJECT: random, random, random
OBJECT: random, random, random
OBJECT: random, random, random
OBJECT: random, random, random
OBJECT: random, random, random
#
MONSTER:'E',"air elemental",random,random
MONSTER:'E',random,random,random
MONSTER:'E',"noxious elemental",random,random
MONSTER:'E',"noxious elemental",random,random
MONSTER:'E',"noxious elemental",random,random
MONSTER:'E',"noxious elemental",random,random
MONSTER:'E',"air elemental",random,random
MONSTER: 'Y', "zruty", random, hostile
MONSTER: 'Y', "zruty", random, hostile
MONSTER: 'Y', "zruty", random, hostile
#
TRAP: random, random
TRAP: random, random
TRAP: random, random
TRAP: random, random
TRAP: random, random
TRAP: random, random
TRAP: random, random

MAZE: "Met-filb" , ' '
INIT_MAP: '.' , 'C' , true , true , lit, false
NOMAP
#
STAIR: random, up
STAIR: random, down
#
OBJECT: random, random, random
OBJECT: random, random, random
OBJECT: random, random, random
OBJECT: random, random, random
OBJECT: random, random, random
#
MONSTER:'E',"air elemental",random,random
MONSTER:'E',"air elemental",random,random
MONSTER:'E',"noxious elemental",random,random
MONSTER:'E',"noxious elemental",random,random
MONSTER:'E',"noxious elemental",random,random
MONSTER:'E',"air elemental",random,random
MONSTER:'E',"noxious elemental",random,random
MONSTER: 'Y', "zruty", random, hostile
MONSTER: 'Y', "zruty", random, hostile
#
TRAP: random, random
TRAP: "falling rock", random
TRAP: "sleep gas", random
TRAP: "falling rock", random
TRAP: "sleep gas", random
TRAP: random, random
TRAP: random, random
